XXXXXXXXXXXXXXXXXXXXXXXXXXXXXXXXXXXXXXXXX
XX________XXXXXXX____________XXXXXX_K__XX
XX________XXXXX____XXXXX________XXX__E_XX
XX______XXXXX____XXXX________XXXXXX____XX
XX_______________XXXXXX_E______XXXXX__XXX
XXXX_____XXXXXX_____________XXXXXXXX___XX
XXXX__XXXXXXXXXX_________XXXXXXXXXX____XX
XX_____XXXXXXX___________XXXXXXXXX___XXXX
XX_____XXXXXXXXXXXXXXX_______________XXXX
XX_____XXXXXXXXXXXXXXX__________XXXXXXXXX
XX____XXXXXXXXXXXXXXXXXXX___E________XXXX
XXXX____XXXXXXXXXXXXXXXXXXX__________XXXX
XX_______________XXX__XXX____XXXXXX____XX
XX_______EEE_____XXX___________XX______XX
XX_______________XXXXXXXXXXXXXXXXXXXXXXXX
XXXXXXXXXXXXXXXXXXXXXXXXXXXXXXXXXXXXXXXXX
XXXXXXXXXXXXXXXXXXXXXXXXXXXXXXXXXXXXXXXXX
XXXXXXXXXXXXXXXXXXXXXXXXXXXXXXXXXXXXXXXXX