XXXXXXXXXXXXXXXXXXXXXXXXXXXXSSSSWWWWWWWWWWWWWWWWWWWWW
X______________________E_____SSSSWWWWWWWWWWWWWWWWWWWW
X_______E_______E____________SSSSWWWWWWWWWWWWWWWWWWWW
X_____________________________SSSWWWSSSSWWWWWWWWWWWWWWW
X______________________________SSSSSSSSSSSWWWWWWWWW
WSSSSSSSSSSSSSSSSSSSSSSSSSSSSSSSSSSSWWWWSSSSSSSSWWWWWW
WWWSSSSSSSSSSSSSSSSeSSSSSSSSSSSSSSWWWWWWWSSSSSSSWWWWWW
WWWSSSSSSSSSSSSSSSSSSSSSSSSSWWWWWWWWWWWWWWWWWSSSWWWWWW
WWWSSSSSWWWWWSSSSSSSSSSSSSWWWWWWWWWSSSWWWWWWWWSSSWWWW
WWWWSSWWWWWWWWWWSSSSSWWWSSWWWWWWWWWWWWWWWWWWWSSSWWWW
WWWWSSWWWWWWWWWWWWWWWWWWSSWWWWWWWWWWWWWWWWWWWWWWWWWWWW
WWWWSSSSWWWWWWWWWWWWWWWWSSWWWWWWWWWWWWWWWWWWWWWWWWWWWWW
WWSSSSSSSSWWWWWWWWWWWWWWSSSSSSSSSSSSSSSSSSSSSWWWWWWWWW
WWWWSSSSSSSWWWWWWWWWWWWSSSSSSeSSSWWWWWWWWWSSSSSWWWWWWW
WWWWWSSSSSSSWWWWWWWWWWWWWWWSSSSSWWWWWWWWWWWWWSSSSSSSSWW
WWWWWWWWSSSSSSSWWWWWWWWWWWWWSSSSWWWWWWWWWWWWWSSSSSSSSSWW
WWWWWWWWWWWSSSSSSWWWWSSSSSSSSSSSWWWWWWWWWWWWWSSSSeSSSWWWWWWWWWWWWWWWWWWWWWWWWWWWWWWWWW
WWSSSSSSSSSSSSSSSWWWWWWWWWWSSSSSSSSSSSSSSSWWSSSSSSSSSWWWWWWWWWWWWWWWWWWWWWWWWWWWWWWWW
WWSSSSSSSSSSSSSSSSSSSSSWWWWWWWWWWSSSSSSSSSSSSSeSSSSSSWWWWWWWWWWWWWWWWWWWWWWWWWWWWWWWW
WWWSSSSSSSSSSSeSSSSSSSSWWWWWWWWWWWWWWWSSSSSSSSSSSSSSWWWWWWWWWWWWWWWWWWWWWWWWWWWWWWWWW
WWWSSSSSSSSSSSSSSSSSSSSSSSWWWWWWWWWWWWWWWWWWWWWWWWWWWWWWWWWWWWWWWWWWWWWWWWWWWWWWWWWWW
WWWWWWWWWWWWWWWWWWWWWWWWSSWWWWWWWWWWWWWWWWWWWWWWWWWWWWWWWWWWWWWWWWWWWWWWWWWWWWWWSKSWW
WWSSSSSSSSSSSSSSSSSSSSSSSSSSSSSSSSSSSSSSSSSSSSSSSSSSSWWWWWWWWWWWWWWWWWWWWWWWWWWWSSWWW
WWSSSSSSSSSSSSSSSSSSSSSSSSSSSSSSSSeSSSSSSSSSSSSSSSSSSWWWWWWWWWWWWWWWWWWWWWWWWWWWSSWWW
WWWWWWWWWWWWWWSSSSSSSSSSSSSSSSSSSSSSSSSSSSSSSSSSSSSSSSSSSSSSSSSSSSSSSSSSSSSSSSSSSSWWW
WWWWWWWWWWWWWWWWWWWWWWWWWWWWWWWWWWWWWWWWWWWWWWWWWWWWWWWWWWWWWWWWWWWWWWWWWWWWWWWWWWWWW
WWWWWWWWWWWWWWWWWWWWWWWWWWWWWWWWWWWWWWWWWWWWWWWWWWWWWWWWWWWWWWWWWWWWWWWWWWWWWWWWWWWWW