WWWWWWWWWWWWWWWWWWWWWWWWWWWWWWWWWWWWWWWWWWW
WWWWSSSSSSSSSSSSSWWWWWWWWWWWWWWWWWWWWWWWWW
WWSSSSSSSSSSSSWWWWWWWWWWWWWWSSSSSSSSWWWWWWWW
WSSSSSSSSSSSWWWWWWWWWWWWSSSSSSSSSSSWWWWWWWWWW
WWWSSSSSSSSSSWWWWWWWWSSSSSSSSSSSWWWWWWWWWWWWW
WWWSSSSSSSSSSSWWWWWWWWSSSSSSSWWWWWWWWWWWWWW
WWWWSSSSSSSSWWWWWWWWWWWSSSSSSWWWWWWWWWWWWWWW
WWWWSSSSSSSSWWWWWWWWWWWWWSSSSSWWWWWWWWWWWWWWW
WWWSSSSSSSWWWWWWWWWWWWWWWSSSSSSSWWWWWWWWWWWW
WWWWSSSSSSSSSSSSSSSWWWWWWWSSSSWWWWWWWWWWWWWWW
WWWWSSSSSSSSSSSSSSSSSSSSSSSSSSSSWWWWWWWWWWWWWWW
WWWWSSSSSSSSSSSSSSSSSSSSSSSSSSSSSSWWWWWWWWWWWWWWWW
WWWSSSSSSSSSSSSSSSSSSSSSSSSSSSSSWWWWWWWWWWWWWWWW
WWWWSSSSSSSSSSSSSSSSSWWWSSSSSSWWWWSSKSSWWWWWWWWW
WWWWSSSSSSSSSeSSSSSSSSSWWWWWWWWSSSSSSeSSSSWWWWWWW
WWWSSSSSSSSSSSSSSSWWWWWWWWSSSSSSSSSSSSSWWWWWWWWW
WWSSSSSSSWWWWWWWSSSSSSSSSSSSSSWWSSeSSSSSWWWWWWWW
WWWSSSSSSWWWWWWWWSSSSSSWWWWWWSSSSSSSWWWWWWWWWWWWWW
WWWWWSSSSSSSSSSSSSSSWWSSSSSSSSSSSSSSSWWWWWWWWWWW
WWWWWWWWWWWWWWWWWWWWWWWWWWWWWWWWWWWWWWWWWWWWWWWW
WWWWWWWWWWWWWWWWWWWWWWWWWWWWWWWWWWWWWWWWWWWWWWWWW