XXXXXXXXXXXXXXXXXXXXXXXX
X_____________________XX
X_____________________XX
X__________________B__XX
X_____________________XX
X_____________________XX
X_____________________XX
X____________K________XX
XXXXXXXXXXXXXXXXXXXXXXXXX
XXXXXXXXXXXXXXXXXXXXXXXXX
XXXXXXXXXXXXXXXXXXXXXXXXX